         _______  _        _______  _______  _______         _______ 
        (  ____ \( \      (  ___  )(  ___  )(  ____ )       / ___   )
        | (    \/| (      | (   ) || (   ) || (    )|   _   \/   )  |
        | (__    | |      | |   | || |   | || (____)|  (_)      /   )
        |  __)   | |      | |   | || |   | ||     __)         _/   /
        | (      | |      | |   | || |   | || (\ (      _    /   _/
        | )      | (____/\| (___) || (___) || ) \ \__  (_)  (   (__/\
        |/       (_______/(_______)(_______)|/   \__/       \_______/
