         _______  _        _______  _______  _______         ______  
        (  ____ \( \      (  ___  )(  ___  )(  ____ )       / ___  \
        | (    \/| (      | (   ) || (   ) || (    )|   _   \/   \  \
        | (__    | |      | |   | || |   | || (____)|  (_)     ___) /
        |  __)   | |      | |   | || |   | ||     __)         (___ (
        | (      | |      | |   | || |   | || (\ (      _         ) \
        | )      | (____/\| (___) || (___) || ) \ \__  (_)  /\___/  /
        |/       (_______/(_______)(_______)|/   \__/       \______/
