         _______  _        _______  _______  _______         _______ 
        (  ____ \( \      (  ___  )(  ___  )(  ____ )       (  __   )
        | (    \/| (      | (   ) || (   ) || (    )|   _   | (  )  |
        | (__    | |      | |   | || |   | || (____)|  (_)  | | /   |
        |  __)   | |      | |   | || |   | ||     __)       | (/ /) |
        | (      | |      | |   | || |   | || (\ (      _   |   / | |
        | )      | (____/\| (___) || (___) || ) \ \__  (_)  |  (__) |
        |/       (_______/(_______)(_______)|/   \__/       (_______)
